jarg : msmd.jar

msmd.Constraint	 <- msmd.Constraint

msmd.DraftFile	 <- msmd.DraftFile
msmd.DraftFile!a	 <- msmd.DraftFile!unclosedDF
msmd.DraftFile!draftCopy	 <- msmd.DraftFile!draftCopy
msmd.DraftFile!finalCopy	 <- msmd.DraftFile!finalCopy
msmd.DraftFile!lmd	 <- msmd.DraftFile!lmd
msmd.DraftFile!lmf	 <- msmd.DraftFile!lmf
msmd.DraftFile!lszd	 <- msmd.DraftFile!lszd
msmd.DraftFile!lszf	 <- msmd.DraftFile!lszf
msmd.DraftFile!closed	 <- msmd.DraftFile!closed
msmd.DraftFile!b	 <- msmd.DraftFile!class$java$lang$Thread
msmd.DraftFile#revertAll()V	 <- msmd.DraftFile#revertAll()V
msmd.DraftFile#temp(Ljava/io/File;)Ljava/io/File;	 <- msmd.DraftFile#temp(Ljava/io/File;)Ljava/io/File;
msmd.DraftFile#copy(Ljava/io/InputStream;Ljava/io/OutputStream;)V	 <- msmd.DraftFile#copy(Ljava/io/InputStream;Ljava/io/OutputStream;)V
msmd.DraftFile#draftOf(Ljava/io/File;)Lmsmd/DraftFile;	 <- msmd.DraftFile#draftOf(Ljava/io/File;)Lmsmd/DraftFile;
msmd.DraftFile#draftTo(Ljava/io/File;)Lmsmd/DraftFile;	 <- msmd.DraftFile#draftTo(Ljava/io/File;)Lmsmd/DraftFile;
msmd.DraftFile#<init>(Ljava/io/File;Ljava/io/File;)V	 <- msmd.DraftFile#<init>(Ljava/io/File;Ljava/io/File;)V
msmd.DraftFile#draftWasModified()Z	 <- msmd.DraftFile#draftWasModified()Z
msmd.DraftFile#finalWasModified()Z	 <- msmd.DraftFile#finalWasModified()Z
msmd.DraftFile#getDraft()Ljava/io/File;	 <- msmd.DraftFile#getDraft()Ljava/io/File;
msmd.DraftFile#getFinal()Ljava/io/File;	 <- msmd.DraftFile#getFinal()Ljava/io/File;
msmd.DraftFile#getDraftOut()Ljava/io/OutputStream;	 <- msmd.DraftFile#getDraftOut()Ljava/io/OutputStream;
msmd.DraftFile#getFinalIn()Ljava/io/InputStream;	 <- msmd.DraftFile#getFinalIn()Ljava/io/InputStream;
msmd.DraftFile#getFinalOut()Ljava/io/OutputStream;	 <- msmd.DraftFile#getFinalOut()Ljava/io/OutputStream;
msmd.DraftFile#getDraftIn()Ljava/io/InputStream;	 <- msmd.DraftFile#getDraftIn()Ljava/io/InputStream;
msmd.DraftFile#commit()V	 <- msmd.DraftFile#commit()V
msmd.DraftFile#revert()V	 <- msmd.DraftFile#revert()V
msmd.DraftFile#delete()V	 <- msmd.DraftFile#delete()V
msmd.DraftFile#finalize()V	 <- msmd.DraftFile#finalize()V
msmd.DraftFile#main([Ljava/lang/String;)V	 <- msmd.DraftFile#main([Ljava/lang/String;)V
msmd.DraftFile#a(Ljava/lang/String;)Ljava/lang/Class;	 <- msmd.DraftFile#class$(Ljava/lang/String;)Ljava/lang/Class;
msmd.DraftFile#<clinit>()V	 <- msmd.DraftFile#<clinit>()V

msmd.a	 <- msmd.DraftFile$1
msmd.a#<init>()V	 <- msmd.DraftFile$1#<init>()V
msmd.a#run()V	 <- msmd.DraftFile$1#run()V

msmd.HTMLReader	 <- msmd.HTMLReader
msmd.HTMLReader!a	 <- msmd.HTMLReader!domCache
msmd.HTMLReader!b	 <- msmd.HTMLReader!cache
msmd.HTMLReader!t	 <- msmd.HTMLReader!t
msmd.HTMLReader#<init>()V	 <- msmd.HTMLReader#<init>()V
msmd.HTMLReader#readPage(Ljava/io/InputStream;)Lorg/w3c/dom/Document;	 <- msmd.HTMLReader#readPage(Ljava/io/InputStream;)Lorg/w3c/dom/Document;
msmd.HTMLReader#readPage(Ljava/net/URL;)Lorg/w3c/dom/Document;	 <- msmd.HTMLReader#readPage(Ljava/net/URL;)Lorg/w3c/dom/Document;
msmd.HTMLReader#readPage(Ljava/lang/String;)Lorg/w3c/dom/Document;	 <- msmd.HTMLReader#readPage(Ljava/lang/String;)Lorg/w3c/dom/Document;
msmd.HTMLReader#readPage(Ljava/io/File;)Lorg/w3c/dom/Document;	 <- msmd.HTMLReader#readPage(Ljava/io/File;)Lorg/w3c/dom/Document;
msmd.HTMLReader#main([Ljava/lang/String;)V	 <- msmd.HTMLReader#main([Ljava/lang/String;)V
msmd.HTMLReader#<clinit>()V	 <- msmd.HTMLReader#<clinit>()V

msmd.Key	 <- msmd.Key
msmd.Key!a	 <- msmd.Key!kb
msmd.Key!b	 <- msmd.Key!data
msmd.Key#hexToBytes(Ljava/lang/String;)[B	 <- msmd.Key#hexToBytes(Ljava/lang/String;)[B
msmd.Key#decode(Ljava/lang/String;)Lmsmd/Key;	 <- msmd.Key#decode(Ljava/lang/String;)Lmsmd/Key;
msmd.Key#a(Ljava/io/InputStream;)Lmsmd/Key;	 <- msmd.Key#decode(Ljava/io/InputStream;)Lmsmd/Key;
msmd.Key#b(Ljava/io/InputStream;)Lmsmd/Key;	 <- msmd.Key#load(Ljava/io/InputStream;)Lmsmd/Key;
msmd.Key#<init>(Ljava/util/Map;)V	 <- msmd.Key#<init>(Ljava/util/Map;)V
msmd.Key#getValue(Ljava/lang/String;)Ljava/lang/String;	 <- msmd.Key#getValue(Ljava/lang/String;)Ljava/lang/String;
msmd.Key#main([Ljava/lang/String;)V	 <- msmd.Key#main([Ljava/lang/String;)V
msmd.Key#<clinit>()V	 <- msmd.Key#<clinit>()V

msmd.Matcher	 <- msmd.Matcher
msmd.Matcher!DEBUG	 <- msmd.Matcher!DEBUG
msmd.Matcher!nodeSiblingPosWeight	 <- msmd.Matcher!nodeSiblingPosWeight
msmd.Matcher!nodeNameWeight	 <- msmd.Matcher!nodeNameWeight
msmd.Matcher!nodeValueWeight	 <- msmd.Matcher!nodeValueWeight
msmd.Matcher!attributeNumberWeight	 <- msmd.Matcher!attributeNumberWeight
msmd.Matcher!childNumberWeight	 <- msmd.Matcher!childNumberWeight
msmd.Matcher!childrenWeight	 <- msmd.Matcher!childrenWeight
msmd.Matcher!attributeWeight	 <- msmd.Matcher!attributeWeight
msmd.Matcher!parentWeight	 <- msmd.Matcher!parentWeight
msmd.Matcher!localWeight	 <- msmd.Matcher!localWeight
msmd.Matcher!cache	 <- msmd.Matcher!cache
msmd.Matcher!seenBefore	 <- msmd.Matcher!seenBefore
msmd.Matcher!a	 <- msmd.Matcher!maxDepth
msmd.Matcher#<init>()V	 <- msmd.Matcher#<init>()V
msmd.Matcher#doMatch(Lorg/w3c/dom/Document;Lorg/w3c/dom/Node;)V	 <- msmd.Matcher#doMatch(Lorg/w3c/dom/Document;Lorg/w3c/dom/Node;)V
msmd.Matcher#getNextMatch()Lmsmd/Matcher$Match;	 <- msmd.Matcher#getNextMatch()Lmsmd/Matcher$Match;
msmd.Matcher#compare(Lorg/w3c/dom/Node;Lorg/w3c/dom/Node;ILmsmd/Matcher$WeightTracker;)F	 <- msmd.Matcher#compare(Lorg/w3c/dom/Node;Lorg/w3c/dom/Node;ILmsmd/Matcher$WeightTracker;)F
msmd.Matcher#compare(Lorg/w3c/dom/Node;Lorg/w3c/dom/Node;I)F	 <- msmd.Matcher#compare(Lorg/w3c/dom/Node;Lorg/w3c/dom/Node;I)F
msmd.Matcher#recursiveComparison(Lorg/w3c/dom/Node;Lorg/w3c/dom/Node;ILmsmd/Matcher$WeightTracker;)F	 <- msmd.Matcher#recursiveComparison(Lorg/w3c/dom/Node;Lorg/w3c/dom/Node;ILmsmd/Matcher$WeightTracker;)F
msmd.Matcher#compareNodes(Lorg/w3c/dom/Node;Lorg/w3c/dom/Node;Lmsmd/Matcher$WeightTracker;)F	 <- msmd.Matcher#compareNodes(Lorg/w3c/dom/Node;Lorg/w3c/dom/Node;Lmsmd/Matcher$WeightTracker;)F
msmd.Matcher#compAttributeNo(Lorg/w3c/dom/Node;Lorg/w3c/dom/Node;)F	 <- msmd.Matcher#compAttributeNo(Lorg/w3c/dom/Node;Lorg/w3c/dom/Node;)F
msmd.Matcher#compChildNo(Lorg/w3c/dom/Node;Lorg/w3c/dom/Node;)F	 <- msmd.Matcher#compChildNo(Lorg/w3c/dom/Node;Lorg/w3c/dom/Node;)F

msmd.Matcher$Match	 <- msmd.Matcher$Match
msmd.Matcher$Match!n	 <- msmd.Matcher$Match!n
msmd.Matcher$Match!closeness	 <- msmd.Matcher$Match!closeness
msmd.Matcher$Match!c	 <- msmd.Matcher$Match!this$0
msmd.Matcher$Match#<init>(Lmsmd/Matcher;)V	 <- msmd.Matcher$Match#<init>(Lmsmd/Matcher;)V

msmd.Matcher$WeightTracker	 <- msmd.Matcher$WeightTracker
msmd.Matcher$WeightTracker!nodeName	 <- msmd.Matcher$WeightTracker!nodeName
msmd.Matcher$WeightTracker!nodeValue	 <- msmd.Matcher$WeightTracker!nodeValue
msmd.Matcher$WeightTracker!attributeNumber	 <- msmd.Matcher$WeightTracker!attributeNumber
msmd.Matcher$WeightTracker!childNumber	 <- msmd.Matcher$WeightTracker!childNumber
msmd.Matcher$WeightTracker!children	 <- msmd.Matcher$WeightTracker!children
msmd.Matcher$WeightTracker!attribute	 <- msmd.Matcher$WeightTracker!attribute
msmd.Matcher$WeightTracker!parent	 <- msmd.Matcher$WeightTracker!parent
msmd.Matcher$WeightTracker!local	 <- msmd.Matcher$WeightTracker!local
msmd.Matcher$WeightTracker!nodeSiblingPos	 <- msmd.Matcher$WeightTracker!nodeSiblingPos
msmd.Matcher$WeightTracker!j	 <- msmd.Matcher$WeightTracker!this$0
msmd.Matcher$WeightTracker#<init>(Lmsmd/Matcher;)V	 <- msmd.Matcher$WeightTracker#<init>(Lmsmd/Matcher;)V
msmd.Matcher$WeightTracker#toString()Ljava/lang/String;	 <- msmd.Matcher$WeightTracker#toString()Ljava/lang/String;
msmd.Matcher$WeightTracker#total()F	 <- msmd.Matcher$WeightTracker#total()F
msmd.Matcher$WeightTracker#reset()V	 <- msmd.Matcher$WeightTracker#reset()V

msmd.Pair	 <- msmd.Pair
msmd.Pair!exact	 <- msmd.Pair!exact
msmd.Pair!a	 <- msmd.Pair!a
msmd.Pair!b	 <- msmd.Pair!b
msmd.Pair#<init>(Lorg/w3c/dom/Node;Lorg/w3c/dom/Node;)V	 <- msmd.Pair#<init>(Lorg/w3c/dom/Node;Lorg/w3c/dom/Node;)V
msmd.Pair#<init>(Lorg/w3c/dom/Node;Lorg/w3c/dom/Node;Z)V	 <- msmd.Pair#<init>(Lorg/w3c/dom/Node;Lorg/w3c/dom/Node;Z)V
msmd.Pair#<init>(Lorg/w3c/dom/Node;)V	 <- msmd.Pair#<init>(Lorg/w3c/dom/Node;)V
msmd.Pair#toString()Ljava/lang/String;	 <- msmd.Pair#toString()Ljava/lang/String;

msmd.StringDist	 <- msmd.StringDist
msmd.StringDist#<init>()V	 <- msmd.StringDist#<init>()V
msmd.StringDist#b(III)I	 <- msmd.StringDist#Minimum(III)I
msmd.StringDist#dist(Ljava/lang/String;Ljava/lang/String;)F	 <- msmd.StringDist#dist(Ljava/lang/String;Ljava/lang/String;)F

msmd.TreeIndex	 <- msmd.TreeIndex
msmd.TreeIndex!INDEX	 <- msmd.TreeIndex!INDEX
msmd.TreeIndex!CHILDCOUNT	 <- msmd.TreeIndex!CHILDCOUNT
msmd.TreeIndex!DEPTH	 <- msmd.TreeIndex!DEPTH
msmd.TreeIndex!DEPTHMARKER	 <- msmd.TreeIndex!DEPTHMARKER
msmd.TreeIndex!index	 <- msmd.TreeIndex!index
msmd.TreeIndex!A	 <- msmd.TreeIndex!A
msmd.TreeIndex!B	 <- msmd.TreeIndex!B
msmd.TreeIndex!C	 <- msmd.TreeIndex!C
msmd.TreeIndex!D	 <- msmd.TreeIndex!D
msmd.TreeIndex!E	 <- msmd.TreeIndex!E
msmd.TreeIndex#a(II)I	 <- msmd.TreeIndex#rotl(II)I
msmd.TreeIndex#<init>(Lorg/w3c/dom/Node;)V	 <- msmd.TreeIndex#<init>(Lorg/w3c/dom/Node;)V
msmd.TreeIndex#getIndexVal(Lorg/w3c/dom/Node;)I	 <- msmd.TreeIndex#getIndexVal(Lorg/w3c/dom/Node;)I
msmd.TreeIndex#getDepth(Lorg/w3c/dom/Node;)I	 <- msmd.TreeIndex#getDepth(Lorg/w3c/dom/Node;)I
msmd.TreeIndex#getChildCount(Lorg/w3c/dom/Node;)I	 <- msmd.TreeIndex#getChildCount(Lorg/w3c/dom/Node;)I
msmd.TreeIndex#getNode(I)Lorg/w3c/dom/Node;	 <- msmd.TreeIndex#getNode(I)Lorg/w3c/dom/Node;
msmd.TreeIndex#b(Lorg/w3c/dom/Node;I)I	 <- msmd.TreeIndex#index(Lorg/w3c/dom/Node;I)I
msmd.TreeIndex#c(Lorg/w3c/dom/Node;)I	 <- msmd.TreeIndex#hashNode(Lorg/w3c/dom/Node;)I
msmd.TreeIndex#d(Lorg/w3c/dom/Node;)I	 <- msmd.TreeIndex#hashNodeDetails(Lorg/w3c/dom/Node;)I
msmd.TreeIndex#main([Ljava/lang/String;)V	 <- msmd.TreeIndex#main([Ljava/lang/String;)V
msmd.TreeIndex#<clinit>()V	 <- msmd.TreeIndex#<clinit>()V

msmd.Version	 <- msmd.Version
msmd.Version!MAJOR	 <- msmd.Version!MAJOR
msmd.Version!MINOR	 <- msmd.Version!MINOR
msmd.Version!VERSION	 <- msmd.Version!VERSION

msmd.WeightedPair	 <- msmd.WeightedPair
msmd.WeightedPair!weight	 <- msmd.WeightedPair!weight
msmd.WeightedPair!a	 <- msmd.WeightedPair!a
msmd.WeightedPair!b	 <- msmd.WeightedPair!b
msmd.WeightedPair#<init>(Lorg/w3c/dom/Node;Lorg/w3c/dom/Node;F)V	 <- msmd.WeightedPair#<init>(Lorg/w3c/dom/Node;Lorg/w3c/dom/Node;F)V
msmd.WeightedPair#toString()Ljava/lang/String;	 <- msmd.WeightedPair#toString()Ljava/lang/String;

msmd.diff.AddChildNode	 <- msmd.diff.AddChildNode
msmd.diff.AddChildNode!a	 <- msmd.diff.AddChildNode!chnode
msmd.diff.AddChildNode!b	 <- msmd.diff.AddChildNode!newchild
msmd.diff.AddChildNode!c	 <- msmd.diff.AddChildNode!refchild
msmd.diff.AddChildNode!d	 <- msmd.diff.AddChildNode!pos
msmd.diff.AddChildNode#<init>(Lorg/w3c/dom/Node;Lorg/w3c/dom/Node;)V	 <- msmd.diff.AddChildNode#<init>(Lorg/w3c/dom/Node;Lorg/w3c/dom/Node;)V
msmd.diff.AddChildNode#<init>(Lorg/w3c/dom/Node;Lorg/w3c/dom/Node;Lorg/w3c/dom/Node;)V	 <- msmd.diff.AddChildNode#<init>(Lorg/w3c/dom/Node;Lorg/w3c/dom/Node;Lorg/w3c/dom/Node;)V
msmd.diff.AddChildNode#remap(Lmsmd/diff/Remapper;)Lmsmd/diff/Difference;	 <- msmd.diff.AddChildNode#remap(Lmsmd/diff/Remapper;)Lmsmd/diff/Difference;
msmd.diff.AddChildNode#markup()V	 <- msmd.diff.AddChildNode#markup()V
msmd.diff.AddChildNode#apply()V	 <- msmd.diff.AddChildNode#apply()V
msmd.diff.AddChildNode#toString()Ljava/lang/String;	 <- msmd.diff.AddChildNode#toString()Ljava/lang/String;

msmd.diff.CanHaveChildrenConstraint	 <- msmd.diff.CanHaveChildrenConstraint
msmd.diff.CanHaveChildrenConstraint#<init>()V	 <- msmd.diff.CanHaveChildrenConstraint#<init>()V
msmd.diff.CanHaveChildrenConstraint#satisfied(Lorg/w3c/dom/Node;)Z	 <- msmd.diff.CanHaveChildrenConstraint#satisfied(Lorg/w3c/dom/Node;)Z

msmd.diff.ChangeValue	 <- msmd.diff.ChangeValue
msmd.diff.ChangeValue!a	 <- msmd.diff.ChangeValue!chnode
msmd.diff.ChangeValue!newVal	 <- msmd.diff.ChangeValue!newVal
msmd.diff.ChangeValue!replS	 <- msmd.diff.ChangeValue!replS
msmd.diff.ChangeValue!replD	 <- msmd.diff.ChangeValue!replD
msmd.diff.ChangeValue#<init>(Lorg/w3c/dom/Node;Ljava/lang/String;Ljava/lang/String;Ljava/lang/String;)V	 <- msmd.diff.ChangeValue#<init>(Lorg/w3c/dom/Node;Ljava/lang/String;Ljava/lang/String;Ljava/lang/String;)V
msmd.diff.ChangeValue#<init>(Lorg/w3c/dom/Node;Ljava/lang/String;)V	 <- msmd.diff.ChangeValue#<init>(Lorg/w3c/dom/Node;Ljava/lang/String;)V
msmd.diff.ChangeValue#remap(Lmsmd/diff/Remapper;)Lmsmd/diff/Difference;	 <- msmd.diff.ChangeValue#remap(Lmsmd/diff/Remapper;)Lmsmd/diff/Difference;
msmd.diff.ChangeValue#markup()V	 <- msmd.diff.ChangeValue#markup()V
msmd.diff.ChangeValue#apply()V	 <- msmd.diff.ChangeValue#apply()V
msmd.diff.ChangeValue#toString()Ljava/lang/String;	 <- msmd.diff.ChangeValue#toString()Ljava/lang/String;

msmd.diff.a	 <- msmd.diff.ChildConstraint
msmd.diff.a!p	 <- msmd.diff.ChildConstraint!p
msmd.diff.a#<init>(Lorg/w3c/dom/Node;)V	 <- msmd.diff.ChildConstraint#<init>(Lorg/w3c/dom/Node;)V
msmd.diff.a#satisfied(Lorg/w3c/dom/Node;)Z	 <- msmd.diff.ChildConstraint#satisfied(Lorg/w3c/dom/Node;)Z

msmd.diff.CopyChildNode	 <- msmd.diff.CopyChildNode
msmd.diff.CopyChildNode!a	 <- msmd.diff.CopyChildNode!chnode
msmd.diff.CopyChildNode!b	 <- msmd.diff.CopyChildNode!copiedNode
msmd.diff.CopyChildNode!c	 <- msmd.diff.CopyChildNode!refchild
msmd.diff.CopyChildNode#<init>(Lorg/w3c/dom/Node;Lorg/w3c/dom/Node;)V	 <- msmd.diff.CopyChildNode#<init>(Lorg/w3c/dom/Node;Lorg/w3c/dom/Node;)V
msmd.diff.CopyChildNode#<init>(Lorg/w3c/dom/Node;Lorg/w3c/dom/Node;Lorg/w3c/dom/Node;)V	 <- msmd.diff.CopyChildNode#<init>(Lorg/w3c/dom/Node;Lorg/w3c/dom/Node;Lorg/w3c/dom/Node;)V
msmd.diff.CopyChildNode#remap(Lmsmd/diff/Remapper;)Lmsmd/diff/Difference;	 <- msmd.diff.CopyChildNode#remap(Lmsmd/diff/Remapper;)Lmsmd/diff/Difference;
msmd.diff.CopyChildNode#markup()V	 <- msmd.diff.CopyChildNode#markup()V
msmd.diff.CopyChildNode#apply()V	 <- msmd.diff.CopyChildNode#apply()V
msmd.diff.CopyChildNode#toString()Ljava/lang/String;	 <- msmd.diff.CopyChildNode#toString()Ljava/lang/String;

msmd.diff.DOMDiff	 <- msmd.diff.DOMDiff
msmd.diff.DOMDiff!a	 <- msmd.diff.DOMDiff!ta
msmd.diff.DOMDiff!b	 <- msmd.diff.DOMDiff!tb
msmd.diff.DOMDiff#<init>()V	 <- msmd.diff.DOMDiff#<init>()V
msmd.diff.DOMDiff#getDiff(Lorg/w3c/dom/Document;Lorg/w3c/dom/Document;)Ljava/util/LinkedList;	 <- msmd.diff.DOMDiff#getDiff(Lorg/w3c/dom/Document;Lorg/w3c/dom/Document;)Ljava/util/LinkedList;
msmd.diff.DOMDiff#getDifference(Lorg/w3c/dom/Node;Lorg/w3c/dom/Node;)Ljava/util/LinkedList;	 <- msmd.diff.DOMDiff#getDifference(Lorg/w3c/dom/Node;Lorg/w3c/dom/Node;)Ljava/util/LinkedList;
msmd.diff.DOMDiff#pairChildren(Lorg/w3c/dom/Node;Lorg/w3c/dom/Node;)Ljava/util/LinkedList;	 <- msmd.diff.DOMDiff#pairChildren(Lorg/w3c/dom/Node;Lorg/w3c/dom/Node;)Ljava/util/LinkedList;

msmd.diff.DeleteElement	 <- msmd.diff.DeleteElement
msmd.diff.DeleteElement!a	 <- msmd.diff.DeleteElement!chnode
msmd.diff.DeleteElement!b	 <- msmd.diff.DeleteElement!elName
msmd.diff.DeleteElement#<init>(Lorg/w3c/dom/Node;Ljava/lang/String;)V	 <- msmd.diff.DeleteElement#<init>(Lorg/w3c/dom/Node;Ljava/lang/String;)V
msmd.diff.DeleteElement#remap(Lmsmd/diff/Remapper;)Lmsmd/diff/Difference;	 <- msmd.diff.DeleteElement#remap(Lmsmd/diff/Remapper;)Lmsmd/diff/Difference;
msmd.diff.DeleteElement#markup()V	 <- msmd.diff.DeleteElement#markup()V
msmd.diff.DeleteElement#apply()V	 <- msmd.diff.DeleteElement#apply()V
msmd.diff.DeleteElement#toString()Ljava/lang/String;	 <- msmd.diff.DeleteElement#toString()Ljava/lang/String;

msmd.diff.Difference	 <- msmd.diff.Difference

msmd.diff.IsAnElementConstraint	 <- msmd.diff.IsAnElementConstraint
msmd.diff.IsAnElementConstraint#<init>()V	 <- msmd.diff.IsAnElementConstraint#<init>()V
msmd.diff.IsAnElementConstraint#satisfied(Lorg/w3c/dom/Node;)Z	 <- msmd.diff.IsAnElementConstraint#satisfied(Lorg/w3c/dom/Node;)Z

msmd.diff.ProcessTxt	 <- msmd.diff.ProcessTxt
msmd.diff.ProcessTxt!r	 <- msmd.diff.ProcessTxt!r
msmd.diff.ProcessTxt!b	 <- msmd.diff.ProcessTxt!message
msmd.diff.ProcessTxt#<init>()V	 <- msmd.diff.ProcessTxt#<init>()V
msmd.diff.ProcessTxt#process(Lorg/w3c/dom/Text;)V	 <- msmd.diff.ProcessTxt#process(Lorg/w3c/dom/Text;)V
msmd.diff.ProcessTxt#process(Lorg/w3c/dom/Node;)V	 <- msmd.diff.ProcessTxt#process(Lorg/w3c/dom/Node;)V
msmd.diff.ProcessTxt#<clinit>()V	 <- msmd.diff.ProcessTxt#<clinit>()V

msmd.diff.RearrangeChildren	 <- msmd.diff.RearrangeChildren
msmd.diff.RearrangeChildren!a	 <- msmd.diff.RearrangeChildren!chnode
msmd.diff.RearrangeChildren!b	 <- msmd.diff.RearrangeChildren!newOrder
msmd.diff.RearrangeChildren#<init>(Lorg/w3c/dom/Node;)V	 <- msmd.diff.RearrangeChildren#<init>(Lorg/w3c/dom/Node;)V
msmd.diff.RearrangeChildren#setNextChild(Lorg/w3c/dom/Node;)V	 <- msmd.diff.RearrangeChildren#setNextChild(Lorg/w3c/dom/Node;)V
msmd.diff.RearrangeChildren#doAnything()Z	 <- msmd.diff.RearrangeChildren#doAnything()Z
msmd.diff.RearrangeChildren#remap(Lmsmd/diff/Remapper;)Lmsmd/diff/Difference;	 <- msmd.diff.RearrangeChildren#remap(Lmsmd/diff/Remapper;)Lmsmd/diff/Difference;
msmd.diff.RearrangeChildren#apply()V	 <- msmd.diff.RearrangeChildren#apply()V
msmd.diff.RearrangeChildren#markup()V	 <- msmd.diff.RearrangeChildren#markup()V
msmd.diff.RearrangeChildren#toString()Ljava/lang/String;	 <- msmd.diff.RearrangeChildren#toString()Ljava/lang/String;

msmd.diff.Remapper	 <- msmd.diff.Remapper
msmd.diff.Remapper!m	 <- msmd.diff.Remapper!m
msmd.diff.Remapper!newDoc	 <- msmd.diff.Remapper!newDoc
msmd.diff.Remapper!hm	 <- msmd.diff.Remapper!hm
msmd.diff.Remapper#<init>(Lorg/w3c/dom/Document;Lorg/w3c/dom/Document;)V	 <- msmd.diff.Remapper#<init>(Lorg/w3c/dom/Document;Lorg/w3c/dom/Document;)V
msmd.diff.Remapper#getCounterpart(Lorg/w3c/dom/Node;)Lorg/w3c/dom/Node;	 <- msmd.diff.Remapper#getCounterpart(Lorg/w3c/dom/Node;)Lorg/w3c/dom/Node;
msmd.diff.Remapper#getCounterpart(Lorg/w3c/dom/Node;Lmsmd/Constraint;)Lorg/w3c/dom/Node;	 <- msmd.diff.Remapper#getCounterpart(Lorg/w3c/dom/Node;Lmsmd/Constraint;)Lorg/w3c/dom/Node;
msmd.diff.Remapper#a(ILorg/w3c/dom/Node;Lorg/w3c/dom/Node;Lmsmd/Constraint;)I	 <- msmd.diff.Remapper#matchAll(ILorg/w3c/dom/Node;Lorg/w3c/dom/Node;Lmsmd/Constraint;)I

msmd.diff.SetAttribute	 <- msmd.diff.SetAttribute
msmd.diff.SetAttribute!a	 <- msmd.diff.SetAttribute!chnode
msmd.diff.SetAttribute!b	 <- msmd.diff.SetAttribute!newElName
msmd.diff.SetAttribute!c	 <- msmd.diff.SetAttribute!newElValue
msmd.diff.SetAttribute#<init>(Lorg/w3c/dom/Element;Ljava/lang/String;Ljava/lang/String;)V	 <- msmd.diff.SetAttribute#<init>(Lorg/w3c/dom/Element;Ljava/lang/String;Ljava/lang/String;)V
msmd.diff.SetAttribute#remap(Lmsmd/diff/Remapper;)Lmsmd/diff/Difference;	 <- msmd.diff.SetAttribute#remap(Lmsmd/diff/Remapper;)Lmsmd/diff/Difference;
msmd.diff.SetAttribute#markup()V	 <- msmd.diff.SetAttribute#markup()V
msmd.diff.SetAttribute#apply()V	 <- msmd.diff.SetAttribute#apply()V
msmd.diff.SetAttribute#toString()Ljava/lang/String;	 <- msmd.diff.SetAttribute#toString()Ljava/lang/String;

msmd.diff.Util	 <- msmd.diff.Util
msmd.diff.Util!a	 <- msmd.diff.Util!id
msmd.diff.Util!t	 <- msmd.diff.Util!t
msmd.diff.Util#<init>()V	 <- msmd.diff.Util#<init>()V
msmd.diff.Util#getId(Lorg/w3c/dom/Node;)Ljava/lang/String;	 <- msmd.diff.Util#getId(Lorg/w3c/dom/Node;)Ljava/lang/String;
msmd.diff.Util#setMod(Lorg/w3c/dom/Node;Ljava/lang/String;)V	 <- msmd.diff.Util#setMod(Lorg/w3c/dom/Node;Ljava/lang/String;)V
msmd.diff.Util#assignIDs(Lorg/w3c/dom/Node;)V	 <- msmd.diff.Util#assignIDs(Lorg/w3c/dom/Node;)V
msmd.diff.Util#assignIDR(Lorg/w3c/dom/Node;)V	 <- msmd.diff.Util#assignIDR(Lorg/w3c/dom/Node;)V
msmd.diff.Util#<clinit>()V	 <- msmd.diff.Util#<clinit>()V

msmd.gui.ApplyDiff	 <- msmd.gui.ApplyDiff
msmd.gui.ApplyDiff#<init>()V	 <- msmd.gui.ApplyDiff#<init>()V

msmd.gui.a	 <- msmd.gui.CellRenderer
msmd.gui.a#<init>()V	 <- msmd.gui.CellRenderer#<init>()V

msmd.gui.CommitChanges	 <- msmd.gui.CommitChanges
msmd.gui.CommitChanges!list	 <- msmd.gui.CommitChanges!list
msmd.gui.CommitChanges#<init>()V	 <- msmd.gui.CommitChanges#<init>()V

msmd.gui.ExampleFileFilter	 <- msmd.gui.ExampleFileFilter
msmd.gui.ExampleFileFilter!a	 <- msmd.gui.ExampleFileFilter!TYPE_UNKNOWN
msmd.gui.ExampleFileFilter!b	 <- msmd.gui.ExampleFileFilter!HIDDEN_FILE
msmd.gui.ExampleFileFilter!c	 <- msmd.gui.ExampleFileFilter!filters
msmd.gui.ExampleFileFilter!d	 <- msmd.gui.ExampleFileFilter!description
msmd.gui.ExampleFileFilter!e	 <- msmd.gui.ExampleFileFilter!fullDescription
msmd.gui.ExampleFileFilter!f	 <- msmd.gui.ExampleFileFilter!useExtensionsInDescription
msmd.gui.ExampleFileFilter#<init>()V	 <- msmd.gui.ExampleFileFilter#<init>()V
msmd.gui.ExampleFileFilter#<init>(Ljava/lang/String;)V	 <- msmd.gui.ExampleFileFilter#<init>(Ljava/lang/String;)V
msmd.gui.ExampleFileFilter#<init>(Ljava/lang/String;Ljava/lang/String;)V	 <- msmd.gui.ExampleFileFilter#<init>(Ljava/lang/String;Ljava/lang/String;)V
msmd.gui.ExampleFileFilter#<init>([Ljava/lang/String;)V	 <- msmd.gui.ExampleFileFilter#<init>([Ljava/lang/String;)V
msmd.gui.ExampleFileFilter#<init>([Ljava/lang/String;Ljava/lang/String;)V	 <- msmd.gui.ExampleFileFilter#<init>([Ljava/lang/String;Ljava/lang/String;)V
msmd.gui.ExampleFileFilter#accept(Ljava/io/File;)Z	 <- msmd.gui.ExampleFileFilter#accept(Ljava/io/File;)Z
msmd.gui.ExampleFileFilter#getExtension(Ljava/io/File;)Ljava/lang/String;	 <- msmd.gui.ExampleFileFilter#getExtension(Ljava/io/File;)Ljava/lang/String;
msmd.gui.ExampleFileFilter#addExtension(Ljava/lang/String;)V	 <- msmd.gui.ExampleFileFilter#addExtension(Ljava/lang/String;)V
msmd.gui.ExampleFileFilter#getDescription()Ljava/lang/String;	 <- msmd.gui.ExampleFileFilter#getDescription()Ljava/lang/String;
msmd.gui.ExampleFileFilter#setDescription(Ljava/lang/String;)V	 <- msmd.gui.ExampleFileFilter#setDescription(Ljava/lang/String;)V
msmd.gui.ExampleFileFilter#setExtensionListInDescription(Z)V	 <- msmd.gui.ExampleFileFilter#setExtensionListInDescription(Z)V
msmd.gui.ExampleFileFilter#isExtensionListInDescription()Z	 <- msmd.gui.ExampleFileFilter#isExtensionListInDescription()Z
msmd.gui.ExampleFileFilter#<clinit>()V	 <- msmd.gui.ExampleFileFilter#<clinit>()V

msmd.gui.MainFrame	 <- msmd.gui.MainFrame
msmd.gui.MainFrame!wiz	 <- msmd.gui.MainFrame!wiz
msmd.gui.MainFrame#<init>()V	 <- msmd.gui.MainFrame#<init>()V
msmd.gui.MainFrame#main([Ljava/lang/String;)V	 <- msmd.gui.MainFrame#main([Ljava/lang/String;)V

msmd.gui.b	 <- msmd.gui.MainFrame$1
msmd.gui.b#<init>()V	 <- msmd.gui.MainFrame$1#<init>()V
msmd.gui.b#windowClosing(Ljava/awt/event/WindowEvent;)V	 <- msmd.gui.MainFrame$1#windowClosing(Ljava/awt/event/WindowEvent;)V

msmd.gui.MultiFileChooser	 <- msmd.gui.MultiFileChooser
msmd.gui.MultiFileChooser!efilter	 <- msmd.gui.MultiFileChooser!efilter
msmd.gui.MultiFileChooser!files	 <- msmd.gui.MultiFileChooser!files
msmd.gui.MultiFileChooser!addFile	 <- msmd.gui.MultiFileChooser!addFile
msmd.gui.MultiFileChooser!addDir	 <- msmd.gui.MultiFileChooser!addDir
msmd.gui.MultiFileChooser!remove	 <- msmd.gui.MultiFileChooser!remove
msmd.gui.MultiFileChooser!w	 <- msmd.gui.MultiFileChooser!w
msmd.gui.MultiFileChooser!lm	 <- msmd.gui.MultiFileChooser!lm
msmd.gui.MultiFileChooser!filter	 <- msmd.gui.MultiFileChooser!filter
msmd.gui.MultiFileChooser!slider	 <- msmd.gui.MultiFileChooser!slider
msmd.gui.MultiFileChooser!msim	 <- msmd.gui.MultiFileChooser!msim
msmd.gui.MultiFileChooser!lsim	 <- msmd.gui.MultiFileChooser!lsim
msmd.gui.MultiFileChooser!a	 <- msmd.gui.MultiFileChooser!firstEntered
msmd.gui.MultiFileChooser!pageScores	 <- msmd.gui.MultiFileChooser!pageScores
msmd.gui.MultiFileChooser!m	 <- msmd.gui.MultiFileChooser!m
msmd.gui.MultiFileChooser#<init>(Lmsmd/gui/Wizard;)V	 <- msmd.gui.MultiFileChooser#<init>(Lmsmd/gui/Wizard;)V
msmd.gui.MultiFileChooser#getTitle()Ljava/lang/String;	 <- msmd.gui.MultiFileChooser#getTitle()Ljava/lang/String;
msmd.gui.MultiFileChooser#nextAllowed()Z	 <- msmd.gui.MultiFileChooser#nextAllowed()Z
msmd.gui.MultiFileChooser#stateChanged(Ljavax/swing/event/ChangeEvent;)V	 <- msmd.gui.MultiFileChooser#stateChanged(Ljavax/swing/event/ChangeEvent;)V
msmd.gui.MultiFileChooser#valueChanged(Ljavax/swing/event/ListSelectionEvent;)V	 <- msmd.gui.MultiFileChooser#valueChanged(Ljavax/swing/event/ListSelectionEvent;)V
msmd.gui.MultiFileChooser#getPreferredSize()Ljava/awt/Dimension;	 <- msmd.gui.MultiFileChooser#getPreferredSize()Ljava/awt/Dimension;
msmd.gui.MultiFileChooser#entered()V	 <- msmd.gui.MultiFileChooser#entered()V
msmd.gui.MultiFileChooser#a(Ljava/io/File;Ljava/io/File;)V	 <- msmd.gui.MultiFileChooser#addAllHtmls(Ljava/io/File;Ljava/io/File;)V
msmd.gui.MultiFileChooser#left()V	 <- msmd.gui.MultiFileChooser#left()V
msmd.gui.MultiFileChooser#actionPerformed(Ljava/awt/event/ActionEvent;)V	 <- msmd.gui.MultiFileChooser#actionPerformed(Ljava/awt/event/ActionEvent;)V
msmd.gui.MultiFileChooser#b(Lorg/w3c/dom/Node;)Lorg/w3c/dom/Node;	 <- msmd.gui.MultiFileChooser#findBODY(Lorg/w3c/dom/Node;)Lorg/w3c/dom/Node;
msmd.gui.MultiFileChooser#c(Ljava/io/File;Lorg/w3c/dom/Document;)F	 <- msmd.gui.MultiFileChooser#calcScore(Ljava/io/File;Lorg/w3c/dom/Document;)F
msmd.gui.MultiFileChooser#d(F)V	 <- msmd.gui.MultiFileChooser#filterUpdate(F)V

msmd.gui.c	 <- msmd.gui.MultiFileChooser$1
msmd.gui.c!a	 <- msmd.gui.MultiFileChooser$1!this$0
msmd.gui.c#<init>(Lmsmd/gui/MultiFileChooser;)V	 <- msmd.gui.MultiFileChooser$1#<init>(Lmsmd/gui/MultiFileChooser;)V
msmd.gui.c#actionPerformed(Ljava/awt/event/ActionEvent;)V	 <- msmd.gui.MultiFileChooser$1#actionPerformed(Ljava/awt/event/ActionEvent;)V

msmd.gui.Review	 <- msmd.gui.Review
msmd.gui.Review!t	 <- msmd.gui.Review!t
msmd.gui.Review!b	 <- msmd.gui.Review!docprogbar
msmd.gui.Review!c	 <- msmd.gui.Review!diffprogbar
msmd.gui.Review!w	 <- msmd.gui.Review!w
msmd.gui.Review!e	 <- msmd.gui.Review!review
msmd.gui.Review!f	 <- msmd.gui.Review!undo
msmd.gui.Review!g	 <- msmd.gui.Review!finished
msmd.gui.Review!h	 <- msmd.gui.Review!message1
msmd.gui.Review!i	 <- msmd.gui.Review!message2
msmd.gui.Review!docmax	 <- msmd.gui.Review!docmax
msmd.gui.Review!diffmax	 <- msmd.gui.Review!diffmax
msmd.gui.Review#getTitle()Ljava/lang/String;	 <- msmd.gui.Review#getTitle()Ljava/lang/String;
msmd.gui.Review#<init>(Lmsmd/gui/Wizard;)V	 <- msmd.gui.Review#<init>(Lmsmd/gui/Wizard;)V
msmd.gui.Review#entered()V	 <- msmd.gui.Review#entered()V
msmd.gui.Review#go(Lmsmd/DraftFile;Ljava/util/LinkedList;)V	 <- msmd.gui.Review#go(Lmsmd/DraftFile;Ljava/util/LinkedList;)V
msmd.gui.Review#updateDiffProgressBar(II)V	 <- msmd.gui.Review#updateDiffProgressBar(II)V
msmd.gui.Review#updateDocProgressBar(II)V	 <- msmd.gui.Review#updateDocProgressBar(II)V
msmd.gui.Review#applyDifferences(Lorg/w3c/dom/Document;Ljava/util/LinkedList;Lmsmd/DraftFile;)V	 <- msmd.gui.Review#applyDifferences(Lorg/w3c/dom/Document;Ljava/util/LinkedList;Lmsmd/DraftFile;)V
msmd.gui.Review#actionPerformed(Ljava/awt/event/ActionEvent;)V	 <- msmd.gui.Review#actionPerformed(Ljava/awt/event/ActionEvent;)V
msmd.gui.Review#nextAllowed()Z	 <- msmd.gui.Review#nextAllowed()Z
msmd.gui.Review#lastAllowed()Z	 <- msmd.gui.Review#lastAllowed()Z
msmd.gui.Review#loopCheck(Lorg/w3c/dom/Node;Ljava/util/Set;)V	 <- msmd.gui.Review#loopCheck(Lorg/w3c/dom/Node;Ljava/util/Set;)V

msmd.gui.d	 <- msmd.gui.Review$1
msmd.gui.d!a	 <- msmd.gui.Review$1!this$0
msmd.gui.d#<init>(Lmsmd/gui/Review;)V	 <- msmd.gui.Review$1#<init>(Lmsmd/gui/Review;)V
msmd.gui.d#run()V	 <- msmd.gui.Review$1#run()V

msmd.gui.SourceChooser	 <- msmd.gui.SourceChooser
msmd.gui.SourceChooser!fname	 <- msmd.gui.SourceChooser!fname
msmd.gui.SourceChooser!browse	 <- msmd.gui.SourceChooser!browse
msmd.gui.SourceChooser!w	 <- msmd.gui.SourceChooser!w
msmd.gui.SourceChooser!editPanel	 <- msmd.gui.SourceChooser!editPanel
msmd.gui.SourceChooser!editLabel	 <- msmd.gui.SourceChooser!editLabel
msmd.gui.SourceChooser!launchEditor	 <- msmd.gui.SourceChooser!launchEditor
msmd.gui.SourceChooser!pageInfoS	 <- msmd.gui.SourceChooser!pageInfoS
msmd.gui.SourceChooser!pageInfoL	 <- msmd.gui.SourceChooser!pageInfoL
msmd.gui.SourceChooser!a	 <- msmd.gui.SourceChooser!forceNext
msmd.gui.SourceChooser#<init>(Lmsmd/gui/Wizard;)V	 <- msmd.gui.SourceChooser#<init>(Lmsmd/gui/Wizard;)V
msmd.gui.SourceChooser#getTitle()Ljava/lang/String;	 <- msmd.gui.SourceChooser#getTitle()Ljava/lang/String;
msmd.gui.SourceChooser#nextAllowed()Z	 <- msmd.gui.SourceChooser#nextAllowed()Z
msmd.gui.SourceChooser#actionPerformed(Ljava/awt/event/ActionEvent;)V	 <- msmd.gui.SourceChooser#actionPerformed(Ljava/awt/event/ActionEvent;)V
msmd.gui.SourceChooser#a(Lorg/w3c/dom/Node;)Ljava/lang/String;	 <- msmd.gui.SourceChooser#findTITLE(Lorg/w3c/dom/Node;)Ljava/lang/String;

msmd.gui.e	 <- msmd.gui.SourceChooser$1
msmd.gui.e!a	 <- msmd.gui.SourceChooser$1!val$chooser
msmd.gui.e!b	 <- msmd.gui.SourceChooser$1!this$0
msmd.gui.e#<init>(Lmsmd/gui/SourceChooser;Ljavax/swing/JFileChooser;)V	 <- msmd.gui.SourceChooser$1#<init>(Lmsmd/gui/SourceChooser;Ljavax/swing/JFileChooser;)V
msmd.gui.e#run()V	 <- msmd.gui.SourceChooser$1#run()V
msmd.gui.e#a(Lmsmd/gui/e;)Lmsmd/gui/SourceChooser;	 <- msmd.gui.SourceChooser$1#access$000(Lmsmd/gui/SourceChooser$1;)Lmsmd/gui/SourceChooser;

msmd.gui.f	 <- msmd.gui.SourceChooser$1$CheckDFMod
msmd.gui.f!t	 <- msmd.gui.SourceChooser$1$CheckDFMod!t
msmd.gui.f!b	 <- msmd.gui.SourceChooser$1$CheckDFMod!start
msmd.gui.f!e	 <- msmd.gui.SourceChooser$1$CheckDFMod!this$1
msmd.gui.f#<init>(Lmsmd/gui/e;Ljava/util/Timer;)V	 <- msmd.gui.SourceChooser$1$CheckDFMod#<init>(Lmsmd/gui/SourceChooser$1;Ljava/util/Timer;)V
msmd.gui.f#run()V	 <- msmd.gui.SourceChooser$1$CheckDFMod#run()V

msmd.gui.Splash	 <- msmd.gui.Splash
msmd.gui.Splash#<init>(Ljava/lang/String;Ljava/awt/Frame;I)V	 <- msmd.gui.Splash#<init>(Ljava/lang/String;Ljava/awt/Frame;I)V

msmd.gui.g	 <- msmd.gui.Splash$1
msmd.gui.g!a	 <- msmd.gui.Splash$1!this$0
msmd.gui.g#<init>(Lmsmd/gui/Splash;)V	 <- msmd.gui.Splash$1#<init>(Lmsmd/gui/Splash;)V
msmd.gui.g#mousePressed(Ljava/awt/event/MouseEvent;)V	 <- msmd.gui.Splash$1#mousePressed(Ljava/awt/event/MouseEvent;)V

msmd.gui.h	 <- msmd.gui.Splash$2
msmd.gui.h!a	 <- msmd.gui.Splash$2!this$0
msmd.gui.h#<init>(Lmsmd/gui/Splash;)V	 <- msmd.gui.Splash$2#<init>(Lmsmd/gui/Splash;)V
msmd.gui.h#run()V	 <- msmd.gui.Splash$2#run()V

msmd.gui.i	 <- msmd.gui.Splash$3
msmd.gui.i!a	 <- msmd.gui.Splash$3!val$pause
msmd.gui.i!b	 <- msmd.gui.Splash$3!val$closerRunner
msmd.gui.i!c	 <- msmd.gui.Splash$3!this$0
msmd.gui.i#<init>(Lmsmd/gui/Splash;ILjava/lang/Runnable;)V	 <- msmd.gui.Splash$3#<init>(Lmsmd/gui/Splash;ILjava/lang/Runnable;)V
msmd.gui.i#run()V	 <- msmd.gui.Splash$3#run()V

msmd.gui.Wizard	 <- msmd.gui.Wizard
msmd.gui.Wizard!a	 <- msmd.gui.Wizard!volatileProperties
msmd.gui.Wizard!b	 <- msmd.gui.Wizard!properties
msmd.gui.Wizard!c	 <- msmd.gui.Wizard!elements
msmd.gui.Wizard!d	 <- msmd.gui.Wizard!currentPane
msmd.gui.Wizard!e	 <- msmd.gui.Wizard!next
msmd.gui.Wizard!f	 <- msmd.gui.Wizard!last
msmd.gui.Wizard!g	 <- msmd.gui.Wizard!register
msmd.gui.Wizard!h	 <- msmd.gui.Wizard!buy
msmd.gui.Wizard!i	 <- msmd.gui.Wizard!title
msmd.gui.Wizard!j	 <- msmd.gui.Wizard!status
msmd.gui.Wizard!k	 <- msmd.gui.Wizard!evalVersion
msmd.gui.Wizard!l	 <- msmd.gui.Wizard!propFile
msmd.gui.Wizard!m	 <- msmd.gui.Wizard!registered
msmd.gui.Wizard!n	 <- msmd.gui.Wizard!class$java$lang$Thread
msmd.gui.Wizard#<init>()V	 <- msmd.gui.Wizard#<init>()V
msmd.gui.Wizard#getPreferredSize()Ljava/awt/Dimension;	 <- msmd.gui.Wizard#getPreferredSize()Ljava/awt/Dimension;
msmd.gui.Wizard#add(Lmsmd/gui/WizardPage;)V	 <- msmd.gui.Wizard#add(Lmsmd/gui/WizardPage;)V
msmd.gui.Wizard#a(Lmsmd/gui/WizardPage;)V	 <- msmd.gui.Wizard#setActive(Lmsmd/gui/WizardPage;)V
msmd.gui.Wizard#b()V	 <- msmd.gui.Wizard#refresh()V
msmd.gui.Wizard#actionPerformed(Ljava/awt/event/ActionEvent;)V	 <- msmd.gui.Wizard#actionPerformed(Ljava/awt/event/ActionEvent;)V
msmd.gui.Wizard#c()V	 <- msmd.gui.Wizard#next()V
msmd.gui.Wizard#d()V	 <- msmd.gui.Wizard#last()V
msmd.gui.Wizard#e(Ljava/lang/String;)Ljava/lang/Class;	 <- msmd.gui.Wizard#class$(Ljava/lang/String;)Ljava/lang/Class;

msmd.gui.j	 <- msmd.gui.Wizard$1
msmd.gui.j!a	 <- msmd.gui.Wizard$1!this$0
msmd.gui.j#<init>(Lmsmd/gui/Wizard;)V	 <- msmd.gui.Wizard$1#<init>(Lmsmd/gui/Wizard;)V
msmd.gui.j#run()V	 <- msmd.gui.Wizard$1#run()V

msmd.gui.k	 <- msmd.gui.Wizard$2
msmd.gui.k!a	 <- msmd.gui.Wizard$2!this$0
msmd.gui.k#<init>(Lmsmd/gui/Wizard;)V	 <- msmd.gui.Wizard$2#<init>(Lmsmd/gui/Wizard;)V
msmd.gui.k#actionPerformed(Ljava/awt/event/ActionEvent;)V	 <- msmd.gui.Wizard$2#actionPerformed(Ljava/awt/event/ActionEvent;)V

msmd.gui.l	 <- msmd.gui.Wizard$3
msmd.gui.l!a	 <- msmd.gui.Wizard$3!val$jf
msmd.gui.l!b	 <- msmd.gui.Wizard$3!val$jt
msmd.gui.l!c	 <- msmd.gui.Wizard$3!this$0
msmd.gui.l#<init>(Lmsmd/gui/Wizard;Ljavax/swing/JFrame;Ljavax/swing/JTextArea;)V	 <- msmd.gui.Wizard$3#<init>(Lmsmd/gui/Wizard;Ljavax/swing/JFrame;Ljavax/swing/JTextArea;)V
msmd.gui.l#actionPerformed(Ljava/awt/event/ActionEvent;)V	 <- msmd.gui.Wizard$3#actionPerformed(Ljava/awt/event/ActionEvent;)V

msmd.gui.WizardPage	 <- msmd.gui.WizardPage
msmd.gui.WizardPage#<init>()V	 <- msmd.gui.WizardPage#<init>()V
msmd.gui.WizardPage#lastAllowed()Z	 <- msmd.gui.WizardPage#lastAllowed()Z
msmd.gui.WizardPage#reset()V	 <- msmd.gui.WizardPage#reset()V
msmd.gui.WizardPage#entered()V	 <- msmd.gui.WizardPage#entered()V
msmd.gui.WizardPage#left()V	 <- msmd.gui.WizardPage#left()V

msmd.sysdep.LaunchBrowser	 <- msmd.sysdep.LaunchBrowser
msmd.sysdep.LaunchBrowser#<init>()V	 <- msmd.sysdep.LaunchBrowser#<init>()V
msmd.sysdep.LaunchBrowser#launch(Ljava/net/URL;)Z	 <- msmd.sysdep.LaunchBrowser#launch(Ljava/net/URL;)Z

msmd.tests.BestMatch	 <- msmd.tests.BestMatch
msmd.tests.BestMatch!a	 <- msmd.tests.BestMatch!hm
msmd.tests.BestMatch#<init>()V	 <- msmd.tests.BestMatch#<init>()V
msmd.tests.BestMatch#findHTML(Lorg/w3c/dom/Document;)Lorg/w3c/dom/Node;	 <- msmd.tests.BestMatch#findHTML(Lorg/w3c/dom/Document;)Lorg/w3c/dom/Node;
msmd.tests.BestMatch#a(Lorg/w3c/dom/Node;Ljava/lang/String;)Lorg/w3c/dom/Node;	 <- msmd.tests.BestMatch#findNode(Lorg/w3c/dom/Node;Ljava/lang/String;)Lorg/w3c/dom/Node;
msmd.tests.BestMatch#b(Lmsmd/Matcher;ILorg/w3c/dom/Node;Lorg/w3c/dom/Node;)V	 <- msmd.tests.BestMatch#matchAll(Lmsmd/Matcher;ILorg/w3c/dom/Node;Lorg/w3c/dom/Node;)V
msmd.tests.BestMatch#main([Ljava/lang/String;)V	 <- msmd.tests.BestMatch#main([Ljava/lang/String;)V
msmd.tests.BestMatch#<clinit>()V	 <- msmd.tests.BestMatch#<clinit>()V

msmd.tests.TestCompare	 <- msmd.tests.TestCompare
msmd.tests.TestCompare#<init>()V	 <- msmd.tests.TestCompare#<init>()V
msmd.tests.TestCompare#a(Lorg/w3c/dom/Document;)Lorg/w3c/dom/Node;	 <- msmd.tests.TestCompare#findHTML(Lorg/w3c/dom/Document;)Lorg/w3c/dom/Node;
msmd.tests.TestCompare#b(Lorg/w3c/dom/Node;Ljava/lang/String;)Lorg/w3c/dom/Node;	 <- msmd.tests.TestCompare#findNode(Lorg/w3c/dom/Node;Ljava/lang/String;)Lorg/w3c/dom/Node;
msmd.tests.TestCompare#main([Ljava/lang/String;)V	 <- msmd.tests.TestCompare#main([Ljava/lang/String;)V

msmd.tests.TestDiff	 <- msmd.tests.TestDiff
msmd.tests.TestDiff#<init>()V	 <- msmd.tests.TestDiff#<init>()V
msmd.tests.TestDiff#main([Ljava/lang/String;)V	 <- msmd.tests.TestDiff#main([Ljava/lang/String;)V

msmd.tests.TestIndex	 <- msmd.tests.TestIndex
msmd.tests.TestIndex#<init>()V	 <- msmd.tests.TestIndex#<init>()V
msmd.tests.TestIndex#mod(Lorg/w3c/dom/Node;Lmsmd/TreeIndex;)V	 <- msmd.tests.TestIndex#mod(Lorg/w3c/dom/Node;Lmsmd/TreeIndex;)V
msmd.tests.TestIndex#main([Ljava/lang/String;)V	 <- msmd.tests.TestIndex#main([Ljava/lang/String;)V

msmd.tests.TestMod	 <- msmd.tests.TestMod
msmd.tests.TestMod#<init>()V	 <- msmd.tests.TestMod#<init>()V
msmd.tests.TestMod#main([Ljava/lang/String;)V	 <- msmd.tests.TestMod#main([Ljava/lang/String;)V

